0,0,0,0,0,0,0,0,0,0,0,0,0,0,0,0,0,0,0,13,22,23,23,22,24,6,6,6,7,13,14,13,13,13,13,13,13,13,13,0,0,0,0,0,0,0,0,0,0,0,0,0,0,0,0,0,0,0
0,0,0,0,0,0,0,0,0,0,0,0,0,0,0,0,0,0,0,13,22,23,23,22,24,6,6,6,7,13,14,13,2,3,3,3,4,13,13,0,0,0,0,0,0,0,0,0,0,0,0,0,0,0,0,0,0,0
0,0,0,0,0,0,0,0,0,0,0,0,0,0,0,0,0,0,0,13,1,2,4,13,2,3,4,22,23,2,3,4,15,1,13,5,6,7,13,0,0,0,0,0,0,0,0,0,0,0,0,0,0,0,0,0,0,0
0,0,0,0,0,0,0,0,0,0,0,0,0,0,0,0,0,0,0,13,21,22,24,13,12,13,14,22,23,12,2,3,4,11,23,15,15,15,13,0,0,0,0,0,0,0,0,0,0,0,0,0,0,0,0,0,0,0
0,0,0,0,0,0,0,0,0,0,0,0,0,0,0,0,0,0,0,13,13,13,15,15,22,2,3,3,4,22,12,13,14,21,2,3,3,3,13,0,0,0,0,0,0,0,0,0,0,0,0,0,0,0,0,0,0,0
0,0,0,0,0,0,0,0,0,0,0,0,0,0,0,0,0,0,0,13,15,15,15,13,15,12,13,31,32,31,32,23,24,15,22,2,5,7,13,0,0,0,0,0,0,0,0,0,0,0,0,0,0,0,0,0,0,0
0,0,0,0,0,0,0,0,0,0,0,0,0,0,0,0,0,0,0,13,5,6,7,13,13,22,23,41,42,41,42,4,15,15,13,22,24,15,13,0,0,0,0,0,0,0,0,0,0,0,0,0,0,0,0,0,0,0
0,0,0,0,0,0,0,0,0,0,0,0,0,0,0,0,0,0,0,13,13,5,6,7,23,24,3,31,32,31,32,14,3,3,4,13,13,13,13,0,0,0,0,0,0,0,0,0,0,0,0,0,0,0,0,0,0,0
0,0,0,0,0,0,0,0,0,0,0,0,0,0,0,0,0,0,0,13,2,4,15,13,12,13,13,41,42,41,42,24,13,13,14,2,3,4,13,0,0,0,0,0,0,0,0,0,0,0,0,0,0,0,0,0,0,0
0,0,0,0,0,0,0,0,0,0,0,0,0,0,0,0,0,0,0,13,22,24,15,13,22,23,1,24,22,23,24,15,23,24,3,22,23,24,13,0,0,0,0,0,0,0,0,0,0,0,0,0,0,0,0,0,0,0
0,0,0,0,0,0,0,0,0,0,0,0,0,0,0,0,0,0,0,13,13,13,13,1,3,4,11,2,3,4,15,2,4,15,13,13,13,13,13,0,0,0,0,0,0,0,0,0,0,0,0,0,0,0,0,0,0,0
0,0,0,0,0,0,0,0,0,0,0,0,0,0,0,0,0,0,0,13,2,3,4,11,23,24,21,12,13,2,4,22,24,15,13,5,6,7,13,0,0,0,0,0,0,0,0,0,0,0,0,0,0,0,0,0,0,0
0,0,0,0,0,0,0,0,0,0,0,0,0,0,0,0,0,0,0,13,12,13,14,21,2,3,4,22,23,12,14,15,5,6,7,5,6,7,13,0,0,0,0,0,0,0,0,0,0,0,0,0,0,0,0,0,0,0
0,0,0,0,0,0,0,0,0,0,0,0,0,0,0,0,0,0,0,13,22,23,24,13,22,23,24,13,13,22,24,13,13,13,13,13,13,13,13,0,0,0,0,0,0,0,0,0,0,0,0,0,0,0,0,0,0,0
0,0,0,0,0,0,0,0,0,0,0,0,0,0,0,0,0,0,0,0,0,0,0,2,4,22,23,24,13,15,6,6,15,12,22,24,23,24,0,0,0,0,0,0,0,0,0,0,0,0,0,0,0,0,0,0,0,0
13,13,13,13,13,13,13,13,13,2,4,13,13,13,13,2,3,3,4,13,13,13,13,12,14,6,6,6,7,13,14,2,3,22,23,23,15,15,13,13,13,13,13,13,13,13,13,13,13,13,13,13,13,13,13,13,13,13
13,2,3,4,12,13,2,3,4,22,24,1,24,5,6,7,13,13,14,13,13,12,13,22,24,1,22,23,23,23,24,12,13,13,12,5,6,7,2,3,4,13,13,5,6,13,5,6,7,13,13,2,4,13,13,13,13,13
13,12,13,14,22,23,31,32,3,3,31,32,2,3,4,15,15,13,14,13,15,22,23,24,15,11,13,2,4,15,15,22,13,13,12,13,14,5,12,13,14,5,6,7,15,13,23,24,3,4,2,22,24,14,3,4,13,13
13,22,2,3,3,4,41,42,13,23,41,42,12,13,14,12,15,13,14,13,15,15,2,3,4,21,13,22,24,15,15,13,13,13,22,23,24,13,22,23,24,13,2,4,15,13,12,13,13,14,12,13,14,24,13,14,13,2
13,15,12,13,5,6,7,22,23,2,3,4,22,23,24,22,23,23,2,3,4,13,12,13,14,3,4,13,13,13,13,13,13,13,15,5,6,7,13,13,15,15,22,24,15,13,22,23,1,24,22,23,24,15,23,24,13,22
13,13,22,23,23,24,2,3,4,15,15,5,6,7,4,13,13,15,12,13,14,13,22,23,24,13,13,13,13,13,13,13,2,4,13,13,13,13,2,3,3,4,31,32,13,13,3,4,11,31,32,4,15,2,4,15,13,13
2,3,3,4,2,4,31,32,3,3,31,32,12,13,14,3,3,4,22,23,24,5,6,7,2,3,4,12,13,2,3,4,22,24,1,24,5,6,7,13,13,14,41,42,4,13,23,24,21,41,42,2,4,22,24,15,13,5
12,14,1,14,22,24,41,42,23,23,41,42,12,13,14,13,15,14,13,2,3,15,4,1,12,13,14,22,23,12,2,3,3,4,11,2,3,4,15,15,13,14,22,23,24,13,2,3,4,22,23,12,14,15,5,6,7,5
22,2,11,4,12,13,13,13,13,22,23,24,22,23,24,1,13,2,3,4,13,13,1,11,22,2,3,3,4,22,12,13,23,24,21,12,13,14,12,15,13,14,13,13,13,13,22,23,24,13,15,22,24,13,13,13,13,13
13,12,21,14,22,2,4,23,5,6,7,1,13,12,5,6,7,12,13,14,5,6,21,11,15,12,13,5,6,7,22,23,2,3,4,22,23,24,22,23,23,2,3,4,13,13,13,13,13,13,15,15,13,13,1,3,4,13
13,22,23,24,13,22,31,32,13,13,15,11,13,22,23,11,24,22,23,24,23,23,24,21,13,22,23,23,24,2,3,4,15,15,5,6,7,4,13,13,15,12,13,14,13,13,13,13,13,13,13,2,3,4,11,13,14,13
6,7,2,3,4,15,41,42,4,15,15,21,2,3,4,21,2,3,4,13,2,3,4,2,3,3,4,31,32,31,32,3,3,3,4,12,13,14,3,3,4,22,23,24,24,3,22,23,23,23,24,12,13,14,21,15,14,13
2,2,12,13,14,13,12,13,14,13,3,4,22,23,24,2,4,5,6,6,7,23,24,12,14,1,14,41,42,41,42,23,23,23,24,12,13,14,13,15,14,13,13,13,13,13,13,13,22,23,24,22,23,24,1,13,2,3
12,12,22,23,2,4,22,23,24,13,5,6,6,15,12,22,24,23,24,13,15,12,13,22,2,11,4,12,13,13,13,13,22,23,24,22,23,24,1,13,2,3,4,13,2,4,23,5,6,7,1,13,12,5,3,4,12,13
12,12,14,7,12,14,5,7,0,0,0,0,0,0,0,0,0,0,0,0,0,0,0,0,0,0,11,11,15,15,2,3,0,0,0,0,0,0,0,0,0,0,0,0,0,0,0,0,0,0,0,0,0,0,23,24,0,0
12,22,24,13,12,14,6,6,6,7,13,14,2,3,22,23,23,15,15,15,13,13,13,13,12,21,14,11,2,4,12,13,13,13,2,3,3,4,13,13,22,23,24,13,22,24,13,13,13,15,11,13,22,23,11,24,22,23
12,14,13,13,22,24,13,12,22,23,23,24,12,13,14,13,5,6,7,13,2,3,4,12,22,2,3,4,22,24,1,24,5,6,7,13,13,14,13,6,7,2,3,4,15,2,3,4,15,15,21,2,3,4,21,2,3,4
12,14,1,14,22,24,3,22,23,23,24,14,12,13,14,13,15,14,13,13,12,13,14,22,23,12,2,3,3,4,11,2,3,4,15,15,5,6,7,13,2,12,13,14,13,12,13,14,13,3,4,22,23,24,2,4,5,6
22,2,11,4,12,13,13,13,13,22,23,24,22,23,24,1,13,2,3,3,22,2,3,3,4,22,12,13,23,24,21,12,13,14,12,15,13,14,13,13,12,22,23,2,4,22,23,24,13,5,6,6,15,12,22,24,23,24
13,12,21,14,22,31,32,23,5,6,7,1,13,12,5,6,7,12,13,13,15,12,13,5,6,7,22,23,2,3,4,22,23,24,22,23,23,2,3,13,22,23,23,12,14,6,6,6,7,13,14,2,3,22,23,23,15,15
13,22,23,24,13,41,42,13,13,13,15,11,13,22,23,11,24,22,23,13,13,22,23,23,24,2,3,4,15,15,5,6,7,4,13,13,15,12,13,4,13,13,13,22,24,13,22,23,23,23,24,12,13,13,13,5,6,7
6,7,2,3,4,15,2,3,4,15,15,21,2,3,4,21,2,3,4,2,3,3,4,2,4,13,2,3,3,3,4,12,13,14,3,3,4,22,23,24,13,13,13,13,13,13,13,13,13,13,22,23,12,14,15,5,6,13
13,2,12,13,14,13,12,13,14,13,3,4,22,23,24,2,4,5,6,12,14,1,14,22,24,3,22,23,23,23,24,12,13,14,13,15,14,13,13,13,15,13,13,13,13,13,13,13,13,13,13,13,13,13,13,13,13,13
13,12,22,23,2,4,22,23,24,13,5,6,6,15,12,22,24,23,24,22,2,11,4,12,13,13,13,13,22,23,24,22,23,24,1,13,2,3,4,13,13,1,13,13,13,13,23,24,3,4,2,3,4,14,3,4,13,13
13,22,23,23,12,14,6,6,6,7,13,14,2,3,22,23,23,15,15,13,12,21,14,22,2,4,23,5,6,7,1,13,12,5,6,7,12,13,14,5,6,21,2,4,15,13,12,13,13,14,12,13,14,24,13,14,13,2
13,6,7,13,22,24,1,22,23,23,23,24,12,13,13,12,5,6,7,13,22,23,24,13,22,24,13,13,13,15,11,13,22,23,11,24,22,23,24,13,13,13,22,24,15,13,22,23,1,24,22,23,24,15,23,24,13,22
13,12,22,23,24,15,11,13,2,4,15,15,22,13,13,12,13,14,5,6,7,2,3,4,15,2,3,4,15,15,21,2,3,4,21,2,3,4,13,2,3,4,13,13,13,13,3,4,11,2,3,4,15,2,4,15,13,13
13,22,23,24,14,13,21,13,22,24,15,15,13,13,13,22,23,24,13,13,2,12,13,14,13,12,13,14,13,3,4,22,23,24,2,4,5,6,6,7,23,24,2,3,4,13,23,24,21,12,13,2,31,32,24,15,13,5
13,13,13,22,24,2,3,4,13,13,13,13,13,13,13,15,5,6,7,13,12,22,23,2,4,22,23,24,13,5,6,6,15,13,22,24,23,24,13,15,12,13,22,23,24,13,2,3,4,22,23,12,41,42,5,6,7,5
13,13,13,13,13,13,13,13,13,13,13,13,13,13,13,13,13,13,13,13,22,23,23,22,24,6,6,6,31,32,14,13,13,13,13,13,13,13,13,13,13,13,13,13,13,13,22,23,24,13,13,22,24,13,13,13,13,13
0,0,0,0,0,0,0,0,0,0,0,0,0,0,0,0,0,0,0,13,13,13,13,13,13,13,13,12,41,42,13,13,13,13,13,13,13,13,13,0,0,0,0,0,0,0,0,0,0,0,0,0,0,0,0,0,0,0
0,0,0,0,0,0,0,0,0,0,0,0,0,0,0,0,0,0,0,13,1,2,4,13,2,3,4,22,23,2,3,4,15,1,13,5,6,7,13,0,0,0,0,0,0,0,0,0,0,0,0,0,0,0,0,0,0,0
0,0,0,0,0,0,0,0,0,0,0,0,0,0,0,0,0,0,0,13,21,22,24,13,12,13,14,22,23,12,2,3,4,11,13,15,15,15,13,0,0,0,0,0,0,0,0,0,0,0,0,0,0,0,0,0,0,0
0,0,0,0,0,0,0,0,0,0,0,0,0,0,0,0,0,0,0,13,13,13,13,13,22,31,32,3,31,32,12,31,32,21,13,13,13,13,13,0,0,0,0,0,0,0,0,0,0,0,0,0,0,0,0,0,0,0
0,0,0,0,0,0,0,0,0,0,0,0,0,0,0,0,0,0,0,13,15,15,15,13,15,41,42,5,41,42,22,41,42,15,13,15,5,7,13,0,0,0,0,0,0,0,0,0,0,0,0,0,0,0,0,0,0,0
0,0,0,0,0,0,0,0,0,0,0,0,0,0,0,0,0,0,0,13,5,6,7,13,13,22,23,23,24,2,3,4,15,15,13,5,7,15,13,0,0,0,0,0,0,0,0,0,0,0,0,0,0,0,0,0,0,0
0,0,0,0,0,0,0,0,0,0,0,0,0,0,0,0,0,0,0,13,13,13,13,13,23,31,32,4,31,32,4,31,32,4,13,13,13,13,13,0,0,0,0,0,0,0,0,0,0,0,0,0,0,0,0,0,0,0
0,0,0,0,0,0,0,0,0,0,0,0,0,0,0,0,0,0,0,13,2,4,15,13,12,41,42,14,41,42,14,41,42,14,13,2,3,4,13,0,0,0,0,0,0,0,0,0,0,0,0,0,0,0,0,0,0,0
0,0,0,0,0,0,0,0,0,0,0,0,0,0,0,0,0,0,0,13,22,24,15,13,22,23,1,24,22,23,24,15,23,24,13,22,23,24,13,0,0,0,0,0,0,0,0,0,0,0,0,0,0,0,0,0,0,0
0,0,0,0,0,0,0,0,0,0,0,0,0,0,0,0,0,0,0,13,13,13,13,13,3,31,32,2,31,32,15,31,32,15,13,13,13,13,13,0,0,0,0,0,0,0,0,0,0,0,0,0,0,0,0,0,0,0
0,0,0,0,0,0,0,0,0,0,0,0,0,0,0,0,0,0,0,13,2,3,4,13,23,41,42,12,41,42,4,41,42,15,13,5,6,7,13,0,0,0,0,0,0,0,0,0,0,0,0,0,0,0,0,0,0,0
0,0,0,0,0,0,0,0,0,0,0,0,0,0,0,0,0,0,0,13,22,23,24,13,2,3,4,22,23,12,14,15,5,6,7,5,6,7,13,0,0,0,0,0,0,0,0,0,0,0,0,0,0,0,0,0,0,0
0,0,0,0,0,0,0,0,0,0,0,0,0,0,0,0,0,0,0,13,13,13,13,13,22,23,24,13,13,22,24,13,13,13,13,13,13,13,13,0,0,0,0,0,0,0,0,0,0,0,0,0,0,0,0,0,0,0
0,0,0,0,0,0,0,0,0,0,0,0,0,0,0,0,0,0,0,13,13,13,13,13,13,13,13,13,13,13,13,13,13,13,13,13,13,13,13,0,0,0,0,0,0,0,0,0,0,0,0,0,0,0,0,0,0,0
0,0,0,0,0,0,0,0,0,0,0,0,0,0,0,0,0,0,0,13,13,13,13,13,13,13,13,13,13,13,13,13,13,13,13,13,13,13,13,0,0,0,0,0,0,0,0,0,0,0,0,0,0,0,0,0,0,0